111111111
1P0C00001
100000001
1C00000E1
111111111
